<map>
000000000000000000000000000000000000000000000000000000000000000000000000000000000000000000000000000000000000000000000000000000000000000000000000000000000000000000000000000000000000000000000000000000000000000000000000000000000101010101010101010100010101010101010001010101010101010100000000000000000000000000000000000000000000000000000000000000000000000000
000000000000000000000000000000000000000000000000000000000000000000000000000000000000000000000000000000000000000004040400000000000000000000000000000000000000000000000000000000000000000000000000000000000000000000000000000000000111111111111111110100011111111111010001111111111111110100000000000000000000000000000000000000000000000000000000000000000000000000
000000000000000000000000000000000000000000000000000000000000000000000000000000000000010101000000010101000000000001010100000000000101010000000000000000000000000000000000000000000000000000000000000000000000000000000000000000000111111111111111110100011111111111010001111111111111110100000000000000000000000000000000000000000000000000000000000000000000000000
000000000000000000000000000000000000000000000000000000000000000000000000000000000000010001010101010001000000000001000101010101010100010000000000000000000000000001100100000000000000000000000000000000000000000000000000000000000111111111111111110100011111111111010001111111111111110100000000000000000000000000000000000000000000000000000000000000000000000000
000000000000000000000000000200000000000000000000000000000000000000000000000000000000010101000000010101000000000001010100000000000101010000000000000000000000000001000101010100000000000000000003000000000000000000000001010101000111111111010101010100010101010101010001010101010101010100000000000000000000000000000000000000000000000000040000000000000000000000
000000000000000000000000000000000000000000000000000000000000000000000000000000000000000100000000000100000000000000000000000000000000000000000000000000000000000001010100000100000000000000000101010000000000010101010001111101000111111111010000000000000000000000000000000000000000000000000000000000000000000000000000000400000000000000010000000000000000000000
000000000000000000000000000000000000000000000000000000000000000000000000000000000000000100000000000100000000000000000000000000000000000000000000000000000000000000010000000100000000000000000100010101010101011111010001111101000111111111010001010101010100010101010101010000000000000000000000000000000004000000000000000100000000000000010000000000000000000000
010100000000000000000000000000000000000000010114000000000012010100000000000110010000000100000000000100000000000000000000000000000000000000000000000000000000000000010000000100000000000000000101010000000000011111010001111101000111111111010001111111110100011111111111010000000000000000000101010101010101010101010101010101010101010101010000000000000000000000
000101010101010101010101010101010101010101010001000000000001000101010101010100010101010100000000000100000000000000000000000000000000000000000000000000000000000000010000000100000000000000000001000000000000011111010001010101000101010111010001111111110100011111111111010000000000000000000100000000000000000000000000000000000000000000000000000000000000000000
010100000000000000000000000000000000000000010101000000000001010100000000000101010000000000000000010101000000000001010100000000000101010000000000000001100100000000010000000100000000000000000001000000000000011111010000000000000000000111010001111111110100011111111111010000000000000000000100000000000000000000000000000000000000000000000001111111111111111101
000000000000000000000000000000000000000000000000000009000000000000000000000000000000000000000000010001000000000001000101010101010100010101010101010101000101010101010000000100000000000000000001000000000000011111010101010101010101000111010001111111110100011111111111010000000101010101010100000000000000000000000000000000000000000000000000000000000000000000
000000000000000000000000000000000000000000000000000000000000000000000000000000000000000000000000010101000000000001010100000000000101010000000000000001010100000000000000000100000001100100000001000000000000011111111111111111111101000101010001010101010100010101010101010000000100000000000000000000000000000000000000000000000000000000000000000000000000000000
000000000000000000000000000000000000000000000000000000000000000000000000000000000000000000000000000000000000000000000000000000000000000000000000000000000000000000000000000101010101000101010101000000000000011111111111111111111101000000000000000000000000000000000000000000000100000000000000000000000000000000000000000000000000000000000000000000000000000000
000000000000000000000000000000000000000000000000000000000000000000000000000000000000000000000000000000000000000000000000000000000000000000000000000000000000000000000000000000000001010100000000000000000000010101010101010101010101010101010101010101010101010101010101010101010100000000000000000000000000000000000000000000000000000000000000000000000000000000
</map>
<tip>
I have taught you everything I know.
</tip>
