<map>
00000000010101010101010101010101010100000101010101010000000000000000000000000000000000000000000000000000000000000000000000000000000000000000000000000000000000000000000101010101010101010101010101010101010101010101010101010101010101010101010101010101010101010101010101010101010101010101010101010101010101010101010101010000000000000000000000
00000000010909090909090909090909090100000109090909010000000000000000000000000000000000000000000000000000000000000000000000000000000000000000000000000000000000000000000109090909090909090909090909090909090909090909090909090909090909090909090909090909090909090909090909090909090909090909090909090909090909090909090909010000040000000400000004
00000000010909090909090909090909090100000109090909010000000000000000000000000000000000000000000000000000000000000000000000000000000000000000000000000000000000000000040109090909090909090909090909090909090909090909090909090909090909090909090909090909090909090909090909090909090909090909090909090909090909090909090909010000100000001000000010
00000000010909090909090909090909090100000109090909010000000000000000000000000000000000000000000000000000000000000000000000000000000000000000000000000000000000000000010109090909090909090909090909090909090909090909090909090909090909090909090909090909090909090909090909090909090909090909090909090909090909090909090909010101010000000101010101
00000000010909090909090909090909090100000109090909010000000000000000000000000000000000000000000000000000000000000000000000000000000000000000000000000000000000000000000000090909090909090909090909090909090909090909090909090909090909090909090909090909090909090909090909090909090909090909090909090909090909090909090909080000000000000000000000
00000000010909090901010101010909090100000109090909010000000000000000000000000000000000000000000000000000000000000000000000000000000000000000000000000000010101010000000000000909090909090909090909090909090909090909090909090909090909090909090909090909090909090909090909090909090909090909090909090909090909090909090909080000000000000000000000
00000000010909090901000000010909090100000109090909010000000001010101000001010101000001010101000001010101000001010101000000000000000000000000000101010100010909010000000000000009090909090909090909090909090909090909090909090909090909090909090909090909090909090909090909090909090909090909090909090909090909090909090909080000000000000000000000
00000000010909090901000000010909090100000109090909010404040401090901040401090901040401090901040401090901040401090901000000000000000001010101000109090100010909010000000000000009090909090909090909090909090909090901010101090909090909090909090909090909090909090909090909090909090909090908090909090909090909090909090909080000000000000000000000
00000000010909090901000000010909090100000109090909010101010101090901010101090901010101090901010101090901010101090901000000010101010001090901000109090100010101010000000000000909090909090909090909090909090909090901090901090909090909090909090909090909090909090909090909080909090909090908090909090909090809090909090909080000000000000000000000
00000000010909090901010101010909090100000109090909090909090909090909090909090909090909090909090909090909090909090901000000010909010001090901000101010100000000000000000000090909090909020909090909090909090909090901090901090909090909090908090909090909090809090909090909080909090909090908090909090909090809090909090909080000000000000000000000
00000000010909090909090909090909090100000109090909090909090909090909090909090909090909090909090909090909090909090901000000010909010001010101000000000000000000000000010109090909090909090909090909090901010101090901090901090909090909090908090909090909090809090909090909080909090909090904090909090909090809090909090909010101010000001111111111
00000000010909090909090909090909090100000109090909010101010101090901010101090901010101090901010101090901010101090901000000010101010000000000000000000000000000000000060109090909090909090909090909090901090901090901090901090909090909090908090909090909090809090909090909040909090909090901090909090909090409090909090909010000100000001000000010
00000000010909090909090909090909090100000109090909010606060601090901060601090901060601090901060601090901060601090901000000000000000000000000000000000000000000000000000109090909090909090909090909090901090901090901090901090909090909090904090909090909090409090909090909010909090909090901090909090909090109090909090909010000060000000600000006
00000000010101010101010101010101010100000101010101010000000001010101000001010101000001010101000001010101000001010101000000000000000000000000000000000000000000000000000101010101010101010101010101010101010101010101010101010101010101010101010101010101010101010101010101010101010101010101010101010101010101010101010101010000000000000000000000
</map>
<tip>
What is this weird place and why does it smell like tofu?
</tip>
