<map>
00000000000000000000000000000000000000000000000000000000000000000000000000000000000000000000000000000000000000000000000000000000000000000000000000000000000000000000000000000000000000000000000000000000000000000000000000000000000000000000000000000000000000000000000000000000000000000000000000000000000000000000000000000000000000000000000000000000
00000000000000000000000000000000000000000000000000000000000000000000010101000000000000000000000000000000000000000000000000000000000000000000000000000000000000000000000000000000000000000000000000000000000000000000000000000000000000000000000000000000000000000000000000000000000000000000000000000000000000000000000000000000000000000000000000000000
00000000000000000000000000000000000000000000000000000000000000000000000100000000000000000000000000000000000000000000000000000000000000000000000000000000000000000000000000000000000000000000000000000000000000000000000000000000000000000000000000000000000000000000000000000000000000000000000000000000000000000000000000000000000000000000000000000000
00000000000000000000000000000000000000000000000000000000000000000000000100000000000000000000000000000000000000000000000000000000000000000000000000000000000000000000000000000000000000000000000000000000000000000000000000000000000000000000000000000000000000000000000000000000000000000000000000000000000000000000000000000000000000000000000000000000
00000000000000000000000000000000000000000000000000000101010000000000000100000000000000000000000000000000000000000000000000000000000000000000000000000000000000000000000000000000000000000000000000000000000000000000000000000000000000000000000000000000000000000101010000000000010101000000000001010100000000000101010000000000000000000000000000000000
00000000000000000000000000000000000000000000000000000001000000000000000100000000000000000000000000000000000000010101000000000001010100000000000101010000000000010101000000000001010100000000000101010000000000010101000000000000000000000000000000000000000000000009000000000000000900000000000000090000000000000009000000000000000000000000000000000000
00000000000000000000000000000000000000000000000000000008000000000000000800000000000000000000000000000000000000000800000000000000080000000000000008000000000000000800000000000000080000000000000008000000000000000800000000000000000000000000000000000000000000000001000000000000000100000000000000010000000000000001000000000000000000000000000000000000
00000000000000000000000000000000000001010100000000000001000000000000000100000000000001010100000000000000000000000100000000000000010000000000000001000000000000000100000000000000010000000000000001000000000000000100000000000000000000000000000000000000000000000001000000000000000100000000000000010000000000000001000000000000000400000000000000000000
00000000000000000000000000000000000000080000000000000001000000000000000100000000000000080000000000000000000000000100000000000000010000000000000001000000000000000100000000000000010000000000000001000000000000000100000000000000000400000004000000000000000000000001000000000000000100000000000000010000000000000001000000000000000100000000000000000000
00000000000000000000000000000000000000010000000000000001000000000000000100000004000000010000000000000000000000000100000000000000010000000000000001000000000000000100000000000000010000000000000001000000000000000100000000000000000100010001000000000009000000000001000000000000000100000000000000010000000000000001000000000000000100000000000000000000
01010101010101010101010101010101010101010101010101010101010101010101010101010101010101010101010101010101010100000100000101010000010000010101000001000001010100000100000101010000010000010101000001000001010100000100000101010101010101010101010101010101010101010101000001010100000100000101010000010000010101000001000001010100000100111111111111111111
00000000000000000000000000000000000000000000000000000000000000000000000000000000000000000000000000000000000000000000000000000000000000000000000000000000000000000000000000000000000000000000000000000000000000000000000000000000000000000000000000000000000000000000000000000000000000000000000000000000000000000000000000000000000000000000000000000000
00000000000000000000000000000000000000000000000000000000000000000000000000000000000000000000000000000000000000000000000000000000000000000000000000000000000000000000000000000000000000000000000000000000000000000000000000000000000000000000000000000000000000000000000000000000000000000000000000000000000000000000000000000000000000000000000000000000
00000000000000000000000000000000000000000000000000000000000000000000000000000000000000000000000000000000000000000000000000000000000000000000000000000000000000000000000000000000000000000000000000000000000000000000000000000000000000000000000000000000000000000000000000000000000000000000000000000000000000000000000000000000000000000000000000000000
</map>
<tip>

</tip>
