<map>
0000000000000000000000000404040004040404040404040404000000040404040004040400000000000000000000000000000000000000000000000000000000040404040000000000000004040404000000040404000404040404040400000000000000000000000000000000000000
0000000000000000000000000101010401010106060606060101040404010101010401010600000000000000000000000000000000000000000000000000000404010101010400000000000401010101040404010101040101010101010100000004040404040404000000000000000000
0000000000000000000000000601010101060600000000000601010101010101010101010000000000000000000000000000000000000000000000000000040101010101010100000000000101060601010101010101010100000000000000000001010101010101040404000000000000
0000000000000000000000000006060606000000000000000006010101010101010101010000000000000000000000000000000000000000000000000004010101060606060600000000000606000000000000000000000000000000000000000000000000010101010101040400000000
0000000000000000000000000000000000000000000000000000060101010101010101060000000000000000000000000000000000000000000100000006060606000000000000000000000000000000000000000000000000000000000000000000000000000001010101010104040000
0000000000000000000000000000000000000000000400000000000101010101010101000000000000000000000000000000000000000000000100000000000000000000000000000000000000000000000000000000000000000000000000000000000000000000010101010101010404
0000000000000000000000000000000000000000000104000000000101010101060606000000000000000000000000000000000001000000000100000000000000000000000000000000000000000004000000000101010100000000000000000000000000000000000000000101010101
0000000000000000000000000000000000000000040101000000000601010106000000000000000000000000000000000000000001040000000104000000000000000000000000000000000000000001010101010101010101010104000000000000000000000000000000000101010101
0000000000000000000000000000000000000000010101000000000001010600000000000000000000000000000000010000000401010000040101000000000000000004000000000001010101010101010101010101010101010101010101000000000000000000111111110101010606
0101010101010101010101010101000000000004010101040000000001010000000000000000000000000000000004010000000101010000010106000000000000000001010101000006010101010101010101010101010101010101010101010101000000040000010101010101060000
0000000000000000000000000001040000000001010101010000000006010000000000000000000000000100000001010400000101060000010100000001010101010101010101000000060101010101010101060606060606010101010101010101010101010101010101010106000000
0000000000000000000000000001010400100001010101010000000000060000000004000000000000040100000006010100000101000000060100000006060101010101010106000000000601010101060606000000000000060606060601010101010101010101010101060600000000
0000000000000000000000000001010104010401010101010000000000000000000401000000000004010104000000010600000601000000000100000000000606010101060600000000000006060606000000000000000000000000000006060606060606010101010606000000000000
0000000000000000000000000001010101010101010101010101010101010101010101010101010101010101000000010000000001000000000100000000000000060606000000000000000000000000000000000000000000000000000000000000000000060606060000000000000000
</map>
<tip>

</tip>
