<map>
000000000000000000000000000000000000000000000000000000000000000000000000000000000000000000000000000000000000000000000000000000000000000000000000000000000000000000000000000000000000000000000000000000000000000000000000
000000000000000000000000000000000000000000000000000000000000000000000000000000000000000000010000000000000000000000000000000000000000000000000000000000000004000000000000000000100000000000000000000000000000000000000000
000000000000000000000000000000000000000000000000000000000000000000000000000000000000000000010000000000000000000000000000000000000000000000000000000000000001010101010101120101010100000000000000000000000000000000000000
000000000000000000000000020000000000000000000000000000000000000000000000000000000000000000010000000000000000000000000000000000000000000000000000000000000001000000000000000000000100000000000000000000000000000000000000
000000000000000000000000000000000000000000000000000000000000000000000000000000000000000000010000000000000000000000000000000000000000000000000000000000000001000000000000000000000100000000000000000000000000000000000000
000000000000000000000000000000000000000000000000000000000000000000000000000000000000000000010000000000000000000000000000000000000000000000000000000000000001000000000000000000000100000000000000000000000000000000000000
000000000000000000000000000000000000000000100000000000000001000000000000000000000010101010010000000000000000000000000000000000000000000000000000001010101001000000000000000000000100000000000000000000000000000000000000
010101010101010101010101010101011201010101010000000000000001010101010101120101010101010101010000000000000000000000000000000000000101010112010101010101010101000000000000000000000100000000000000000000000000000000000000
000000000000000000000000000000000000000000010000000000000001000000000000000000000000000000010000000000000000000000000000000000000100000000000000000000000000000000000000000000000100000000000000000000000000000000000000
000000000000000000000000000000000000000000010101010101010101000000000000000000000000000000010000000000000000000000000000000000000100000000000000000000000000000000000000000000000100000000000000000000000000000000000000
000000000000000000000000000000000000000000010000000000000001000000000000000000000000000000010000000000000000000000000000000000000100000000000000000000000000000000000000000000000100000000000000000000000000000000000000
000000000000000000000000000000000000000000060000000000000006000000000000000000000000000000010000000000000000000000000000000000000100000000000000000000000000000000000000000000000100000000000000000000000000000000000000
000000000000000000000000000000000000000000000000000000000000000000000000000000000000000000010000000000000000000000000000101010100100000000000000000000000000000000000000000000000100000000000000000000000000000000000000
000000000000000000000000000000000000000000000000000000000000000000000000000000000000000000010101010101010101011201010101010101010100000000000000000000000000000000000000000000000111111111111111111111111111111111110000
</map>
<tip>
Bouncy blocks give you wings!
</tip>
