<map>
000000000000000000000000000000000000000000000000000000000000000000000000000000000000000000000000000000000000000000000000000000000000000000000000000000000000000000000000000000000000000000
000000000000000000000000000000000000000000000000000000000000000000000000000000000000000000000000000000000000000000000000000000000000000000000000000000000000000000000000000000000000000000
000000000000000000000000000000000000000000000000000000000000000000000000000000000000000000000000000000000000000000000000000000000000000000000000000000000000000000000000000000000000000000
000000000000000000000000000000000000000200000000000000000000000000000000000000000000000000000000000000000000000000000000000000000000000400000000000000000000000000000000000000000000000000
000000000000000000000000000000000000000000000000000000000000000000000000000000000000000000000000000000000000000000000101010101010112010101010114000000010101140000000101011400000001010101
000000000000000000000000000000000000000000000000000000000000000000000000000000000000000000000000000000000000000000000000000701000000000000000001000000010000010000000100000100000001000001
000000000000000000000000000000000000000000000300000000000000000000000000000000000000000003000000000000000000000000000000000701000000000000000001000000010000010000000100000100000001000001
010101010101010101010101010101010101010101010101010112000000000000000000000000000000010101010100000001010101011201010101010101000000000000000001000400010101010004000101010100000001010101
000000000000000000000000000000000000000000000000000001000000000000000000000000000000000000070100000001050000000000000000000000000000000000000001000000000000000000000000000000000000000001
000000000000000000000000000000000000000000000000000001000000000000000000000000000000000000070100000001050000000000000000000000000000000000000001000000000000000000000000000000000000000001
000000000000000000000000000000000000000000000000000001000000000101010101010101120101010101010100000001010101010000000000000000000000000000000001000000000000000000000000000000000000000001
000000000000000000000000000000000000000000000000000001000000000100000000000000000000000000000000000000000000000000000000000000000000000000000001000000000000000000000000000000000000000001
000000000000000000000000000000000000000000000000000001040404040100000000000000000000000000000000000000000000000000000000000000000000000000000001111111111111111111111111111111111111111101
000000000000000000000000000000000000000000000000000001010101010100000000000000000000000000000000000000000000000000000000000000000000000000000000000000000000000000000000000000000000000000
</map>
<tip>
Don't you hate having to start all over? This new block will get rid of all the icky feelings.
</tip>
